Underworld
An Interactive Fiction by Devin Weaver
Release 1 / Serial number 111101 / Inform 7 build 6G60 (I6/v6.32 lib 6/12N) SD

Garden
You are at the bottom of a hill that is covered in florishing grass. Trees encompass the hill in the distance. A small garden surrounds you. Little ankle high flowers fill the dirt that surrounds a small warn path. The path heads up a hill.

>x trees
You see nothing special about the trees.

>x hill
You see nothing special about the hill.

>x flowers
The flowers are neatly arranged by color. They have grown to great size and color. You notice something between the peddles that seems out of place.

>search flowers
You found a door knob!

>i
You are carrying:
  a door knob

>x flowers
The flowers are neatly arranged by color. They have grown to great size and color.

>search flowers
You find nothing of interest.

>u
Front Yard
This looks like the side of a hill and if you didn't know any better you would think that. You see a few round windows set within the grassy hill and a round inset with a door big enogh for you to enter if you were to crouch down a bit. There is a warn path winding down the hill to the garden.

>search flowers
You can't see any such thing.

>x door
(the door knob)
You see nothing special about the door knob.

>x wooden door
An ornate wodden door is set into the round alcove of the hill. You notice that there is no door knob and there for no way to open it at it is now.

>open wooden door
It seems to be locked.

* * *

Underworld
An Interactive Fiction by Devin Weaver
Release 1 / Serial number 111101 / Inform 7 build 6G60 (I6/v6.32 lib 6/12N) SD

Garden
You are at the bottom of a hill that is covered in florishing grass. Trees encompass the hill in the distance. A small garden surrounds you. Little ankle high flowers fill the dirt that surrounds a small warn path. The path heads up a hill.

>n
Front Yard
This looks like the side of a hill and if you didn't know any better you would think that was the case. Instead, you see a few round windows set within the grassy hill and a round inset with a door big enogh for you to enter if you were to crouch down a bit. There is a warn path winding down the hill to the garden.

>unlock the door
What do you want to unlock the wooden door with?

>purloin knob
[Purloined.]

>unlock the door with knob
(the wooden door with the door knob)
You carefully slide the door knob onto the wooden door until you hear a small click. The door knob now looks like it is a part of the wooden door.

>x door
An ornate wodden door is set into the round alcove of the hill.

>open it
You open the wooden door.

>n
Vestuble
A rounded room that looks very much like the inside of a very large tree. The cealing has candleabras hanging from it which gives a soothing glow to the room. An opening the size of the wall opens north to another room. A small door leads outside to the south.

You can see a giant three headed dog is laying here. There is a tag hanging that reads "Cerberus". Each head has glistening teeth and verying degrees of slobber dripping from it's curled mouth. All six eyes are staring at you intensely.

One of Cerberus's heads licks his paws.

>s
Front Yard
This looks like the side of a hill and if you didn't know any better you would think that was the case. Instead, you see a few round windows set within the grassy hill and a round inset with a door big enogh for you to enter if you were to crouch down a bit. There is a warn path winding down the hill to the garden.

>enter
You must supply a noun.

>enter door
Vestuble
A rounded room that looks very much like the inside of a very large tree. The cealing has candleabras hanging from it which gives a soothing glow to the room. An opening the size of the wall opens north to another room. A small door leads outside to the south.

You can see a giant three headed dog is laying here. There is a tag hanging that reads "Cerberus". Each head has glistening teeth and verying degrees of slobber dripping from it's curled mouth. All six eyes are staring at you intensly.

>take hound
I don't suppose Cerberus would care for that.

* * *

>n
Vestuble
A rounded room that looks very much like the inside of a very large tree. The cealing has candleabras hanging from it which gives a soothing glow to the room. An opening the size of the wall opens north to another room. A small door leads outside to the south.

You can see a giant three headed dog is laying here. There is a tag hanging that reads "Cerberus". Each head has glistening teeth and verying degrees of slobber dripping from it's curled mouth. All six eyes are staring at you intensely.

One of Cerberus's heads licks his paws.

>z
Time passes.

One of Cerberus's heads shakes violently sending spit in every direction.

* * *

Underworld
An Interactive Fiction by Devin Weaver
Release 1 / Serial number 111101 / Inform 7 build 6G60 (I6/v6.32 lib 6/12N) SD

Garden
You are at the bottom of a hill that is covered in florishing grass. Trees encompass the hill in the distance. A small garden surrounds you. Little ankle high flowers fill the dirt that surrounds a small warn path. The path heads up a hill.

>search flowers
You found a door knob!

>take it
Taken.

>smell the flowers
The sweet scent of candy corn fills your nostrals.

* * *

Underworld
An Interactive Fiction by Devin Weaver
Release 1 / Serial number 111101 / Inform 7 build 6G60 (I6/v6.32 lib 6/12N) SD

Garden
You are at the bottom of a hill that is covered in florishing grass. Trees encompass the hill in the distance. A small garden surrounds you. Little ankle high flowers fill the dirt that surrounds a small warn path. The path heads up a hill.

>inspect the flowers
That's not a verb I recognise.

>examine flowers
The flowers are neatly arranged by color. They have grown to great size and color. You notice something between the peddles that seems out of place.

>search flowers
You found a door knob!

>examine door knob
A small plain brass door knob.

>look around
You can't see any such thing.

>look
Garden
You are at the bottom of a hill that is covered in florishing grass. Trees encompass the hill in the distance. A small garden surrounds you. Little ankle high flowers fill the dirt that surrounds a small warn path. The path heads up a hill.

You can see a door knob here.

>examine grass
The flowers are neatly arranged by color. They have grown to great size and color.

>examine trees
You see nothing special about the trees.

>walk up hill
I only understood you as far as wanting to walk up.

>walk up
Front Yard
This looks like the side of a hill and if you didn't know any better you would think that was the case. Instead, you see a few round windows set within the grassy hill and a round inset with a door big enogh for you to enter if you were to crouch down a bit. There is a warn path winding down the hill to the garden.

>examine door
An ornate wodden door is set into the round alcove of the hill. You notice that the door knob has gone missing and there no way to open it now.

>use door knob
That's not a verb I recognise.

>i
You are carrying nothing.

>walk down
Garden
You are at the bottom of a hill that is covered in florishing grass. Trees encompass the hill in the distance. A small garden surrounds you. Little ankle high flowers fill the dirt that surrounds a small warn path. The path heads up a hill.

You can see a door knob here.

>pick up door knob
Taken.

>walk up
Front Yard
This looks like the side of a hill and if you didn't know any better you would think that was the case. Instead, you see a few round windows set within the grassy hill and a round inset with a door big enogh for you to enter if you were to crouch down a bit. There is a warn path winding down the hill to the garden.

>turn knob
Nothing obvious happens.

>open door
(the wooden door)
You cannot open this door with out replacing the missing door knob.

>unlock door
(the wooden door with the door knob)
You carefully slide the door knob onto the wooden door until you hear a small click. The door knob now looks like it is a part of the wooden door.

>n
(first opening the wooden door)

Vestuble
A rounded room that looks very much like the inside of a very large tree. The cealing has candleabras hanging from it which gives a soothing glow to the room. An opening the size of the wall opens north to another room. A small door leads outside to the south.

You can see a giant three headed dog is laying here. There is a tag hanging that reads "Cerberus". Each head has glistening teeth and verying degrees of slobber dripping from it's curled mouth. All six eyes are staring at you intensely.

* * *

Underworld
An Interactive Fiction by Devin Weaver
Release 1 / Serial number 111101 / Inform 7 build 6G60 (I6/v6.32 lib 6/12N) SD

Garden
You are at the bottom of a hill that is covered in florishing grass. Trees encompass the hill in the distance. A small garden surrounds you. Little ankle high flowers fill the dirt that surrounds a small warn path. The path heads up a hill.

>score
You have so far scored 0 out of a possible 10, in 1 turn, earning you the rank of an unawakened mind.

>search grass
You found a door knob!

[Your score has just gone up by five points.]

>take knob
Taken.

>n
Front Yard
This looks like the side of a hill and if you didn't know any better you would think that was the case. Instead, you see a few round windows set within the grassy hill and a round inset with a door big enogh for you to enter if you were to crouch down a bit. There is a warn path winding down the hill to the garden.

>put knob on door
(the wooden door)
You carefully slide the door knob onto the wooden door until you hear a small click. The door knob now looks like it is a part of the wooden door.

[Your score has just gone up by five points.]

>score
You have so far scored 10 out of a possible 10, in 5 turns, earning you the rank of an opened mind.